20 20 50 0
0 0 -1 0 0 0 -1 0 0 0 0 -1 0 0 0 0 -1 0 0 0
0 -1 0 0 -1 0 0 0 -1 0 0 0 0 -1 0 0 0 0 -1 0
-1 0 0 0 0 -1 0 0 0 -1 0 0 -1 0 0 0 -1 0 0 0
0 0 -1 0 0 0 0 -1 0 0 0 -1 0 0 0 0 0 -1 0 15
0 0 0 -1 0 0 -1 0 0 0 -1 0 0 0 -1 0 0 0 0 0
-1 0 0 0 0 -1 0 0 0 -1 0 0 0 -1 0 0 -1 0 0 0
0 0 -1 0 0 0 0 -1 0 0 0 0 -1 0 0 0 0 0 -1 0
0 -1 0 0 0 -1 0 0 0 -1 0 0 0 0 -1 0 0 0 0 9
0 0 0 -1 0 0 0 0 -1 0 0 -1 0 0 0 0 -1 0 0 0
-1 0 0 0 0 -1 0 0 0 0 -1 0 0 0 -1 0 0 0 -1 0
0 0 -1 0 0 0 0 -1 0 0 0 0 -1 0 0 0 0 -1 0 0
0 -1 0 0 -1 0 0 0 0 -1 0 0 0 -1 0 0 -1 0 0 0
0 0 0 -1 0 0 -1 0 0 0 0 -1 0 0 0 0 0 0 -1 0
-1 0 0 0 0 -1 0 0 0 -1 0 0 0 0 -1 0 0 0 0 12
0 0 -1 0 0 0 0 -1 0 0 0 -1 0 0 0 0 -1 0 0 0
0 -1 G 0 0 -1 0 0 0 0 -1 0 0 0 0 -1 0 0 -1 0
0 0 0 -1 0 0 0 0 -1 0 0 0 -1 0 0 0 0 0 0 0
-1 0 0 0 0 -1 0 0 0 -1 0 0 0 0 -1 0 0 -1 0 0
0 0 -1 0 0 0 -1 0 0 0 0 -1 0 0 0 0 -1 0 7 S
0 -1 0 0 0 -1 0 0 0 0 0 -1 0 0 0 -1 0 0 0 0