10 10 30 20
0 0 0 0 0 0 0 0 -1 -1 0 0 0 0 0
0 0 0 0 0 0 S 0 0 0 0 0 -1 -1 -1
0 0 0 0 0 0 0 -1 -1 -1 0 0 -1 0 -1
0 0 0 0 0 0 0 0 0 -1 0 0 -1 0 0
0 0 0 0 0 0 0 -1 -1 -1 0 0 -1 -1 0
0 0 0 0 0 1 0 -1 0 0 0 0 0 -1 0
0 0 0 0 0 0 0 0 0 -1 -1 -1 -1 -1 0
0 0 0 0 0 0 0 0 0 -1 0 0 0 -1 0
0 0 0 0 0 0 -1 -1 -1 -1 0 0 0 -1 0
0 0 0 0 0 0 0 5 0 0 0 -1 -1 -1 G
0 0 0 0 0 0 0 0 0 0 0 0 0 0 0
0 0 0 0 0 0 0 0 0 0 0 0 0 0 0
0 0 0 0 0 0 0 0 0 0 0 0 0 0 0
0 0 0 0 0 0 0 0 0 0 0 0 0 0 0
0 0 0 0 0 0 0 0 0 0 0 0 0 0 0