14 14 45 25
0 -1 0 0 F1 -1 0 0 0 0 -1 0 0 0
-1 0 0 -1 0 0 0 -1 0 0 0 -1 0 0
0 0 -1 0 0 -1 0 0 0 -1 0 0 0 -1
0 -1 0 0 0 0 -1 0 7 0 0 -1 0 0
-1 0 0 0 -1 0 0 0 -1 0 0 0 -1 0
0 0 -1 0 0 F3 0 -1 0 0 -1 0 0 0
0 -1 0 0 -1 0 0 0 0 -1 0 0 F5 -1
-1 S 0 0 0 -1 0 0 -1 0 0 0 0 0
0 0 -1 0 0 0 0 -1 0 0 0 -1 0 0
0 -1 0 0 -1 4 0 0 0 -1 0 0 0 -1
-1 0 0 0 0 -1 0 0 -1 0 0 0 -1 0
0 0 -1 F2 0 0 -1 0 0 0 -1 G 0 0
0 -1 0 0 0 -1 0 0 -1 11 0 0 0 -1
F4 0 0 -1 0 0 0 -1 0 0 0 -1 0 0