18 18 45 0
0 -1 0 0 0 -1 0 0 0 G -1 0 0 0 0 -1 0 0
0 -1 0 0 -1 0 0 0 -1 0 0 0 0 -1 0 0 0 0
-1 0 0 0 0 -1 0 0 0 -1 0 0 -1 0 0 0 -1 0
0 0 -1 0 0 0 0 -1 0 0 0 -1 0 0 0 0 0 14
0 0 0 -1 0 0 -1 0 0 0 -1 0 0 0 -1 0 0 0
-1 0 0 0 0 -1 0 0 0 -1 0 0 0 -1 0 0 -1 0
0 0 -1 0 0 0 0 -1 0 0 0 0 -1 0 0 0 0 0
0 -1 0 0 0 -1 0 0 0 -1 0 0 0 0 -1 0 0 0
0 0 0 -1 0 0 0 0 -1 0 0 -1 0 0 0 0 -1 0
-1 0 0 0 0 -1 0 0 0 0 -1 0 0 0 -1 0 0 8
0 0 -1 0 0 0 0 -1 0 0 0 0 0 -1 0 0 0 0
0 -1 0 0 -1 0 0 0 0 -1 0 0 0 -1 0 0 -1 0
0 0 0 -1 0 0 -1 0 0 0 0 -1 0 0 0 0 0 0
-1 0 0 0 0 -1 0 0 0 -1 0 0 0 0 -1 0 0 0
0 0 -1 0 0 0 0 -1 0 0 0 -1 0 0 0 0 -1 0
0 -1 0 0 0 -1 0 0 0 0 -1 0 0 0 0 -1 0 0
0 0 0 -1 0 0 0 0 -1 S 0 0 -1 0 0 0 0 0
-1 0 0 0 0 -1 0 0 0 -1 0 0 0 0 -1 0 0 11