10 10 34 100
G 0 0 -1 0 9 0 0 -1 0
0 0 0 0 -1 -1 -1 0 0 0
0 -1 -1 0 0 1 0 0 -1 0
0 0 0 -1 0 -1 -1 0 0 0
-1 -1 0 0 9 0 -1 -1 0 -1
0 0 0 -1 -1 0 0 7 0 0
0 -1 -1 0 0 0 -1 -1 0 -1
0 0 2 0 -1 0 0 0 0 0
-1 -1 -1 0 0 -1 0 -1 -1 0
0 0 0 0 -1 0 3 0 S 0