8 10 15 100
0 -1 0 -1 -1 0 -1 0 -1 0
-1 0 0 0 -1 0 8 0 0 3
0 0 0 0 S 0 0 0 0 0
0 0 0 0 -1 0 -1 0 0 0
-1 0 -1 0 -1 0 -1 -1 0 -1
0 3 0 -1 0 7 0 5 0 0
-1 0 G 0 0 0 -1 0 0 0
0 -1 2 0 0 -1 0 0 9 -1