10 10 15 8
-1 0 0 0 0 -1 -1 0 0 0
0 5 0 0 0 0 0 0 0 0
0 0 -1 -1 -1 0 0 G 0 0
0 0 -1 0 -1 0 0 0 0 0
0 -1 -1 -1 -1 0 0 0 -1 -1
1 0 -1 0 0 0 0 0 -1 -1
0 0 0 0 0 4 0 8 0 0
-1 -1 0 0 -1 -1 -1 -1 0 0
0 -1 S 0 0 0 0 -1 0 0
0 0 0 0 -1 0 0 -1 0 0