10 10 25 10
S 0 -1 0 0 5 0 0 0 0
0 0 0 -1 0 0 0 -1 0 0
0 0 -1 0 0 -1 0 0 0 0
0 0 0 0 -1 0 0 0 0 7
-1 6 0 -1 0 0 0 -1 0 0
0 0 0 13 0 0 -1 0 -1 0
0 0 -1 -1 0 0 0 0 -1 0
0 -1 0 0 0 -1 0 0 G 0
0 0 0 0 0 0 0 -1 0 0
0 0 -1 4 0 0 0 0 -1 0