12 10 21 12
0 0 -1 0 F1 0 0 -1 0 0
0 0 -1 G -1 -1 0 0 0 -1
0 0 0 0 0 0 -1 0 -1 0
-1 -1 0 -1 0 0 0 0 0 0
0 0 0 -1 -1 F3 -1 -1 F2 0
0 -1 0 0 0 0 0 0 -1 0
0 -1 -1 -1 4 -1 0 -1 0 0
F4 0 0 0 0 0 0 0 0 -1
0 0 -1 -1 0 -1 0 0 -1 0
-1 1 S 0 0 0 0 0 0 0
0 -1 0 -1 -1 0 -1 -1 0 0
0 0 0 0 0 -1 0 0 0 0