11 11 30 0
0 0 -1 -1 0 -1 0 0 0 0 -1 
0 -1 0 0 -1 7 0 -1 0 0 0 
0 G 0 -1 9 0 0 0 -1 0 0 
3 0 0 0 0 -1 0 0 15 0 0 
0 -1 0 0 8 0 0 -1 0 0 14 
-1 0 11 0 -1 -1 10 0 -1 0 0 
0 0 0 -1 0 4 0 0 0 0 0 
0 0 -1 0 5 0 -1 0 0 0 0 
6 0 0 0 -1 0 0 0 0 -1 0 
0 0 0 -1 0 0 -1 0 0 0 S 
0 0 0 9 0 0 0 0 0 0 0 