10 10 30 0
S 0 -1 0 0 5 0 0 0 0
0 0 0 -1 0 0 0 -1 0 0
0 0 -1 0 0 -1 0 0 0 0
0 0 0 0 -1 0 0 0 0 7
-1 3 0 -1 0 0 0 -1 0 0
0 0 0 100 0 0 -1 0 -1 0
0 0 -1 -1 0 0 0 0 -1 0
0 -1 0 0 0 -1 0 0 G 0
0 0 0 0 0 0 0 -1 0 0
0 0 -1 4 0 0 0 0 -1 0