16 16 30 0
0 -1 0 0 -1 0 0 0 -1 0 0 0 0 -1 0 0
-1 0 0 0 0 -1 0 0 0 -1 0 0 -1 0 0 9
0 0 -1 0 0 0 0 -1 0 0 0 -1 0 0 0 0
0 0 0 -1 0 0 -1 0 0 0 -1 0 0 0 -1 0
-1 0 0 0 0 -1 0 0 0 -1 0 0 0 -1 0 0
0 0 -1 0 0 S 0 -1 0 0 0 0 -1 0 0 0
0 -1 0 0 0 -1 0 0 0 -1 0 0 0 0 -1 0
0 0 0 -1 0 0 0 0 -1 0 0 -1 0 0 0 13
-1 0 0 0 0 -1 0 0 0 0 -1 0 0 0 -1 0
0 0 -1 0 0 0 0 -1 0 0 0 0 -1 0 0 0
0 -1 0 0 -1 0 0 0 0 -1 0 0 0 -1 0 0
0 0 0 -1 0 0 -1 0 0 0 0 -1 0 0 0 0
-1 0 0 0 0 -1 0 0 0 -1 0 0 0 0 -1 0
0 0 -1 0 0 0 0 -1 0 0 0 -1 0 0 0 0
0 -1 0 0 0 -1 0 0 0 0 -1 0 0 G 0 6
0 0 0 -1 0 0 0 0 -1 0 0 0 -1 0 0 0